1111111111111111111
1000000001000000001
1511011101011101151
1011011101011101101
1000000000000000001
1011010111110101101
1000010001000100001
1111011191911101111
9991019999999101999
1111019119119101111
9999099199919909999
1111019111119101111
9991019999999101999
1111019111119101111
1000000001000000001
1011011101011101101
150100000P000001051
1101010111110101011
1000010001000100001
1011111101011111101
1000000000000000001
1111111111111111111