00000000000011000000000000
01111011111011011111011110
01111011111011011111011110
01111011111011011111011110
00000000000000000000000000
01111011011111111011011110
01111011011111111011011110
00000011000011000011000000
11111011111011011111011111
11111011111011011111011111
11111011000000000011011111
11111011011100111011011111
11111011010000001011011111
00000000010000001000000000
11111011010000001011011111
11111011011111111011011111
11111011000000000011011111
11111011011111111011011111
11111011011111111011011111
00000000000011000000000000
01111011111011011111011110
01111011111011011111011110
00011000000000000000011000
11011011011111111011011011
11011011011111111011011011
00000011000011000011000000
01111111111011011111111110
01111111111011011111111110
00000000000000000000000000